in a sense - в некотором смысле
eagerly - охотно
exhausted - сильно уставший; выдохшийся
certain - уверенный; убежденный
crucial - ключевой; решающий
credible - достоверный; надежный
Shall we begin? - Может, начнем?
Good god - Боже милостивый
I'll do the rest - Я сделаю все остальное
attend - присутствовать
won't you? - не так ли?
aim - цель
afford - позволять себе
I've had enough - С меня хватит
I guess - Я думаю
the side of a mountain - на склоне горы
he isn't a human being - он не человек
uncertainly - неуверенно
curiously - любопытно
lecture - лекция
sandbox - песочница
experience - опыт
secondary school - средняя школа
classmate - одноклассник
fewer - меньше
because of - потому что
participate - участвовать
headphones - наушники
college - колледж
electricity circuit - электрическая цепь
I'm worry - я беспокоюсь
pigeon - голубь
dove - белый голубь
penpal - друг по переписке
drum - барабан
to digest - переваривать
dishwasher - посудомоечная машина
metal fatigue - усталость металла
pile of snow - куча снега
preservatives - консерванты
dwarf - карлик; гном
a puchase - покупка; приобретение
adore - обожать
творог - curds
to brush - чистить щеткой; причесывать
unsociable - необщительный; нелюдимый
hospitality - гостеприимство
foodie - любитель поесть; гурман
implausible - неправдоподобный
vibe - флюиды; ощущения; атмосфера
menial - чернорабочий; неквалифицированный; малозначимый
arrogant - высокомерный
formality - формальность; принятая форма
staff turnover - текучесть кадров
to treat - обращаться; обходиться (с кем-либо)
a treat - подарок; угощение
sit around - сидеть без дела; сидеть сложа руки
twilight - сумерки
fall out - ссориться
up to you - вам решать